.............
.............
.R....B......
....O........
......O......
.B....M..B...
.............
...R..Y......
..B.....M....
.....O...B...
.............
