.............
...O..R......
..M..........
.B.......B...
.....O.......
.M..Y..R.....
.............
......B......
.....R..M....
.O....B......
.............
