.............
.B...........
..O....M.....
...R......B..
.............
....O....R...
.....B..O....
.M...........
....R..Y.....
..B.....M....
.............
