.............
.............
.R...........
.....B.......
.O....M......
...Y...M..O..
.B.....M.B...
.............
......R......
.B.....O.....
.....M.......
