.............
....O..R.....
.....M.......
..B.......B..
.............
..R..Y..R....
.............
..B.....M.B..
.............
....R..O.....
.............
