.............
.............
.O.....B.....
.....O.......
..B....M.....
...R....O....
.....M.......
....Y..R.....
.B...........
....R.....B..
.............
