.............
.O..R........
........B....
.....O.......
.Y..R.....B..
.....O..M....
.B...M...B...
.............
....R..M.....
..B..........
.............
