.............
.....O.......
....R........
...M.........
.B...Y....B..
.....O.......
.............
.M....B......
....R........
...B.....R...
.............
