.............
....R..M.....
.....M.......
.O....B......
....O........
.B....M..B...
.....Y..R....
.............
.B.....M.....
....O..M.....
.............
