.............
.R.....O.....
...M.........
..B....Y.....
.O....M......
....B....B...
......R......
.............
...B...O.....
.O...R.......
.....M.......
